kmer,tox#,comp#,tox/comp,tox-comp,tox+comp,charge,hphobic,KD_HPHOBIC,ROSE_HPHOBIC,z-value,p-value
YICY,36,0,INF,36,36,0,3,4.40,3.31,5.29,0.00
YCVI,39,1,39.00,38,40,0,3,9.90,3.41,4.06,0.00
YFCY,36,1,36.00,35,37,0,3,2.70,3.31,5.64,0.00
VCYI,31,1,31.00,30,32,0,3,9.90,3.41,4.56,0.00
YRFF,31,1,31.00,30,32,1,3,-0.20,3.16,4.85,0.00
FCRL,31,1,31.00,30,32,1,2,4.60,3.28,2.73,0.00
FYYI,29,1,29.00,28,30,0,4,4.70,3.28,4.49,0.00
FYII,38,2,19.00,36,40,0,4,10.50,3.40,5.64,0.00
VYII,35,2,17.50,33,37,0,4,11.90,3.38,5.30,0.00
ICFI,35,2,17.50,33,37,0,3,14.30,3.55,5.24,0.00
YCIV,32,2,16.00,30,34,0,3,9.90,3.41,2.86,0.00
FCYI,29,2,14.50,27,31,0,3,8.50,3.43,4.32,0.00
YFIY,33,3,11.00,30,36,0,4,4.70,3.28,3.80,0.00
YIII,32,3,10.67,29,35,0,4,12.20,3.40,5.27,0.00
FFYF,32,3,10.67,29,35,0,4,7.10,3.40,4.20,0.00
FCYF,32,3,10.67,29,35,0,3,6.80,3.43,3.25,0.00
FCII,32,3,10.67,29,35,0,3,14.30,3.55,4.47,0.00
YYII,32,3,10.67,29,35,0,4,6.40,3.28,6.78,0.00
FYIY,31,3,10.33,28,34,0,4,4.70,3.28,4.65,0.00
YYCY,31,3,10.33,28,34,0,3,-1.40,3.19,4.11,0.00
VYFI,30,3,10.00,27,33,0,4,10.20,3.38,4.69,0.00
FIIY,30,3,10.00,27,33,0,4,10.50,3.40,4.48,0.00
VFII,30,3,10.00,27,33,0,4,16.00,3.50,4.35,0.00
YVIF,29,3,9.67,26,32,0,4,10.20,3.38,4.93,0.00
YYIY,29,3,9.67,26,32,0,4,0.60,3.16,2.78,0.00
FYFG,29,3,9.67,26,32,0,3,3.90,3.24,4.51,0.00
YVYY,29,3,9.67,26,32,0,4,0.30,3.14,2.96,0.00
IVYI,27,3,9.00,24,30,0,4,11.90,3.38,3.13,0.00
FCFI,27,3,9.00,24,30,0,3,12.60,3.55,3.75,0.00
FVIY,27,3,9.00,24,30,0,4,10.20,3.38,3.69,0.00
YYFI,27,3,9.00,24,30,0,4,4.70,3.28,3.02,0.00
YIIF,43,5,8.60,38,48,0,4,10.50,3.40,4.79,0.00
YCXL,187,23,8.13,164,210,0,2,5.00,2.52,8.82,0.00
IYYF,32,4,8.00,28,36,0,4,4.70,3.28,4.23,0.00
YIIY,30,4,7.50,26,34,0,4,6.40,3.28,4.09,0.00
YIFY,30,4,7.50,26,34,0,4,4.70,3.28,3.14,0.00
FYFI,29,4,7.25,25,33,0,4,8.80,3.40,3.92,0.00
YFIV,36,5,7.20,31,41,0,4,10.20,3.38,5.21,0.00
YXLF,199,28,7.11,171,227,0,3,5.30,2.49,9.77,0.00
YVFY,34,5,6.80,29,39,0,4,4.40,3.26,5.96,0.00
YIVY,27,4,6.75,23,31,0,4,6.10,3.26,4.68,0.00
FYYF,27,4,6.75,23,31,0,4,3.00,3.28,1.37,0.09
LFII,27,4,6.75,23,31,0,4,15.60,3.49,4.39,0.00
FRIF,26,4,6.50,22,30,1,3,5.60,3.28,2.59,0.00
FYVV,38,6,6.33,32,44,0,4,9.90,3.36,5.21,0.00
YCXI,231,37,6.24,194,268,0,2,5.70,2.55,7.26,0.00
FFYG,30,5,6.00,25,35,0,3,3.90,3.24,3.37,0.00
IIFY,30,5,6.00,25,35,0,4,10.50,3.40,4.46,0.00
YXLY,163,28,5.82,135,191,0,3,1.20,2.37,7.96,0.00
FXYF,226,39,5.79,187,265,0,3,4.30,2.52,8.45,0.00