kmer,tox#,comp#,tox/comp,tox-comp,tox+comp,charge,hphobic,KD_HPHOBIC,ROSE_HPHOBIC,z-value,p-value
YFXYF,38,0,INF,38,38,0,4,3.00,3.28,5.53,0.00
YFCYX,31,0,INF,31,31,0,3,2.70,3.31,5.39,0.00
YICYX,30,0,INF,30,30,0,3,4.40,3.31,4.84,0.00
FYIIX,35,1,35.00,34,36,0,4,10.50,3.40,5.90,0.00
YIIXY,33,1,33.00,32,34,0,4,6.40,3.28,5.10,0.00
VYIIX,33,1,33.00,32,34,0,4,11.90,3.38,5.19,0.00
YCVIX,32,1,32.00,31,33,0,3,9.90,3.41,3.56,0.00
XYCVI,32,1,32.00,31,33,0,3,9.90,3.41,3.47,0.00
XVYII,31,1,31.00,30,32,0,4,11.90,3.38,5.08,0.00
YCIVX,30,1,30.00,29,31,0,3,9.90,3.41,2.69,0.00
XYFCY,30,1,30.00,29,31,0,3,2.70,3.31,5.47,0.00
FYXIF,34,2,17.00,32,36,0,4,8.80,3.40,7.12,0.00
YYIIX,30,2,15.00,28,32,0,4,6.40,3.28,6.61,0.00
XYIII,30,2,15.00,28,32,0,4,12.20,3.40,5.36,0.00
VFXIY,29,2,14.50,27,31,0,4,10.20,3.38,4.06,0.00
YFCXF,29,2,14.50,27,31,0,3,6.80,3.43,4.89,0.00
VYFIX,28,2,14.00,26,30,0,4,10.20,3.38,4.25,0.00
YXLFV,28,2,14.00,26,30,0,4,9.50,3.35,3.42,0.00
ICFIX,28,2,14.00,26,30,0,3,14.30,3.55,4.50,0.00
VFIIX,28,2,14.00,26,30,0,4,16.00,3.50,4.38,0.00
XYIIF,35,3,11.67,32,38,0,4,10.50,3.40,4.58,0.00
FYVXF,30,3,10.00,27,33,0,4,8.50,3.38,6.70,0.00
XYIVF,29,3,9.67,26,32,0,4,10.20,3.38,4.65,0.00
XYFIY,29,3,9.67,26,32,0,4,4.70,3.28,3.52,0.00
FCYFX,29,3,9.67,26,32,0,3,6.80,3.43,3.20,0.00
YXLFX,172,18,9.56,154,190,0,3,5.30,2.49,9.18,0.00
FFXRY,28,3,9.33,25,31,1,3,-0.20,3.16,3.92,0.00
XIIFY,28,3,9.33,25,31,0,4,10.50,3.40,4.37,0.00
IYFVX,28,3,9.33,25,31,0,4,10.20,3.38,3.86,0.00
XIYYF,27,3,9.00,24,30,0,4,4.70,3.28,3.69,0.00
YXIYF,27,3,9.00,24,30,0,4,4.70,3.28,6.15,0.00
FXIIR,27,3,9.00,24,30,1,3,7.30,3.28,3.27,0.00
YYIYX,27,3,9.00,24,30,0,4,0.60,3.16,2.71,0.00
YIIFX,35,4,8.75,31,39,0,4,10.50,3.40,4.07,0.00
XXFYL,131,15,8.73,116,146,0,3,5.30,2.49,7.55,0.00
XYXLF,163,19,8.58,144,182,0,3,5.30,2.49,8.95,0.00
FYVVX,34,4,8.50,30,38,0,4,9.90,3.36,4.94,0.00
YIXFI,32,4,8.00,28,36,0,4,10.50,3.40,4.33,0.00
YXIFY,32,4,8.00,28,36,0,4,4.70,3.28,5.20,0.00
XYCXL,149,19,7.84,130,168,0,2,5.00,2.52,7.66,0.00
YVFYX,30,4,7.50,26,34,0,4,4.40,3.26,5.59,0.00
YXCYX,179,24,7.46,155,203,0,2,-0.10,2.43,10.07,0.00
YXVYV,29,4,7.25,25,33,0,4,5.80,3.24,3.92,0.00
YXFFF,29,4,7.25,25,33,0,4,7.10,3.40,4.38,0.00
FRXFF,29,4,7.25,25,33,1,3,3.90,3.28,4.36,0.00
YIIXV,36,5,7.20,31,41,04,,11.90,3.38,4.17,0.00
XIYIV,28,4,7.00,24,32,0,4,11.90,3.38,5.78,0.00
XYCXI,189,27,7.00,162,216,0,2,5.70,2.55,6.00,0.00
FYCXI,27,4,6.75,23,31,0,3,8.50,3.43,1.37,0.08
YFIVX,27,4,6.75,23,31,0,4,10.20,3.38,4.60,0.00