kmer,tox#,comp#,tox/comp,tox-comp,tox+comp,charge,hphobic,KD_HPHOBIC,ROSE_HPHOBIC,z-value,p-value
FYL,201,50,4.02,151,251,0,3,5.30,2.49,9.02,0.00
YYF,251,68,3.69,183,319,0,3,0.20,2.40,7.93,0.00
FYF,249,68,3.66,181,317,0,3,4.30,2.52,8.89,0.00
YYL,169,48,3.52,121,217,0,3,1.20,2.37,8.36,0.00
YLY,156,47,3.32,109,203,0,3,1.20,2.37,6.78,0.00
FFY,238,72,3.31,166,310,0,3,4.30,2.52,8.75,0.00
LYF,165,50,3.30,115,215,0,3,5.30,2.49,8.23,0.00
FYY,206,65,3.17,141,271,0,3,0.20,2.40,7.34,0.00
IYY,208,67,3.10,141,275,0,3,1.90,2.40,8.43,0.00
YYI,218,72,3.03,146,290,0,3,1.90,2.40,8.41,0.00
YFF,208,70,2.97,138,278,0,3,4.30,2.52,7.88,0.00
YLF,198,67,2.96,131,265,0,3,5.30,2.49,8.50,0.00
YYY,174,59,2.95,115,233,0,3,-3.90,2.28,7.47,0.00
YFY,194,68,2.85,126,262,0,3,0.20,2.40,8.64,0.00
YFL,189,72,2.63,117,261,0,3,5.30,2.49,8.69,0.00
LFF,170,65,2.62,105,235,0,3,9.40,2.61,5.74,0.00
LYL,118,46,2.57,72,164,0,3,6.30,2.46,7.25,0.00
FLY,177,69,2.57,108,246,0,3,5.30,2.49,6.88,0.00
YFI,244,97,2.52,147,341,0,3,6.00,2.52,9.80,0.00
YLL,104,42,2.48,62,146,0,3,6.30,2.46,6.29,0.00
IYF,216,88,2.45,128,304,0,3,6.00,2.52,10.01,0.00
FFL,182,76,2.39,106,258,0,3,9.40,2.61,5.89,0.00
CYF,189,79,2.39,110,268,0,2,4.00,2.55,6.44,0.00
YIL,169,71,2.38,98,240,0,3,7.00,2.49,5.09,0.00
FIY,216,91,2.37,125,307,0,3,6.00,2.52,6.35,0.00
IYL,163,70,2.33,93,233,0,3,7.00,2.49,7.00,0.00
FYI,222,96,2.31,126,318,0,3,6.00,2.52,8.46,0.00
YIY,188,85,2.21,103,273,0,3,1.90,2.40,7.12,0.00
YII,249,113,2.20,136,362,0,3,7.70,2.52,9.49,0.00
FRL,141,64,2.20,77,205,1,2,2.10,2.37,5.16,0.00
CYL,174,79,2.20,95,253,0,2,5.00,2.52,5.99,0.00
LFY,138,63,2.19,75,201,0,3,5.30,2.49,6.42,0.00
CYI,218,100,2.18,118,318,0,2,5.70,2.55,7.87,0.00
FLF,181,84,2.15,97,265,0,3,9.40,2.61,7.25,0.00
LYY,135,63,2.14,72,198,0,3,1.20,2.37,6.32,0.00
RFF,169,79,2.14,90,248,1,2,1.10,2.40,6.52,0.00
FFF,205,96,2.14,109,301,0,3,8.40,2.64,4.50,0.00
RLF,131,62,2.11,69,193,1,2,2.10,2.37,5.87,0.00
YYC,189,92,2.05,97,281,0,2,-0.10,2.43,5.89,0.00
LYI,178,87,2.05,91,265,0,3,7.00,2.49,6.47,0.00
FCY,198,97,2.04,101,295,0,2,4.00,2.55,6.55,0.00
IFY,195,96,2.03,99,291,0,3,6.00,2.52,7.19,0.00
IIY,198,98,2.02,100,296,0,3,7.70,2.52,7.46,0.00
YIF,199,99,2.01,100,298,0,3,6.00,2.52,6.13,0.00
LFI,180,90,2.00,90,270,0,3,11.10,2.61,5.75,0.00
YLI,150,76,1.97,74,226,0,3,7.00,2.49,5.38,0.00
IYI,186,95,1.96,91,281,0,3,7.70,2.52,6.68,0.00
ILY,143,75,1.91,68,218,0,3,7.00,2.49,4.85,0.00
LFL,117,62,1.89,55,179,0,3,10.40,2.58,5.09,0.00
YRL,111,59,1.88,52,170,1,2,-2.00,2.25,4.39,0.00
